香港	Hong Kong
澳门	Macau
海南	Hainan
黑龙江	Heilongjiang
甘肃	Gansu
四川	Sichuan
上海	Shanghai
青海	Qinghai
其他	Qita
浙江	Zhejiang
广西	Guangxi
重庆	Zhongqing
广东	Guangdong
天津	Tianjin
吉林	Jilin
北京	Beijing
山西	Shanxi
辽宁	Liaoning
内蒙古	Neimenggu
安徽	Anhui
江苏	Jiangsu
新疆	Xinjiang
河南	Henan
福建	Fujian
湖南	Hunan
西藏	Xizang
河北	Hebei
湖北	Hubei
江西	Jiangxi
云南	Yunnan
贵州	Guizhou
陕西	Shanxi
海外	Haiwai
台湾	Taiwan
山东	Shandong
宁夏	Ningxia